%%%%%%%%%%%%%%%%%%%%%%%%%%%%%%%%%%%%%%%%%%%%%%%%%%%%%%%%%%%%%%%%%%%%%%%%%%%%%%%%%%%%%%%%%%%%%%%%%%%%%
%P%           %           %     %       % %                   %   % %     %       %           %     %
% %%%%%%%%% % % % %%%%%%% % %%% % % %%% % % %%%%%%% % %%%%%%% % % % % % %%% %%%%% % %%% %%%%% % %%%%%
%     %     % % % % %     %   % % %   %   % %       % %   %     %   % %     %   %   % %     %   %   %
%%%%% % %%%%% %%% % % %%%%% % %%% %%% % %%% % %%%%%%% % % %%%%%%%%% % %%%%%%% % %%%%% %%%%% %%%%% % %
%   % % %   %     % % %     % %   %   % %   %   %     % %   %     % %     % % %         %   %     % %
% %%% % %%% %%%%%%% % %%%%%%% % %%% %%% % %%%%% %%% %%% %%% % %%% %%%%%%% % % %%% %%%%%%% %%% %%%%% %
%   % % %   %       %   %   %   % % %   %     %   % %   % %   % %       % %     %     %   %   %   % %
%%% % % % % %%% %%% %%% % % % %%% % %%%%% %%%%% % %%% %%% %%%%% %%% % %%% %%%%% %%%%% % % % %%% % % %
%   %   % %   % %     % % % %     % %     %   % %           %     % % %   %   %   %   % % % %   % % %
% %%%%%%% %%% %%% %%%%% % % % %%%%% % %%%%% % %%%%%%% %%%%% %%% % % %%% %%% % %%%%% % % %%% %%% %%% %
% %     % %       %   %   % % %   % % %   % %       % %   %     % % %   %   %       % %   %   % %   %
% % % % % %%% %%%%% % %%%%% % % % % % % % % %%%%%%% %%% % %%%%%%%%% % %%%%% %%%%%%%%% %%% %%% % % %%%
%   % % %   % %     %     % % % % %   % % %       %   % %   %   %   %       %   %   % % %     % %   %
%%%%% % % % %%% %%%%%%% %%% %%% % % %%%%% %%%%%%% %%% % %%% % % % %%% %%%%%%% %%% % % % %%%%%%% %%% %
%     % % % %     %   %   %     % %     %   %   %   %   % % % %   %   %     %     % %   %       %   %
% %%%%% %%% % %%%%% % %%% %%%%%%% %%%%% %%% % % %%% %%%%% % % %%%%% %%% %%% %%% %%% %%% %%%%%%% % % %
% %   %   %   %     %         % % %   %   % % %   %     % % % %     % % % %   % %   %   %       % % %
% % % %%% %%%%% %%% %%%%%%%%% % % % % %%% % % %%% % %%% % % % % %%%%% % % %%% %%% %%% %%% %%% %%% % %
% % % %         %   %       %   %   % % % % % %   % %   %   % %   %   % %   %   % %   %   % % %   % %
% % % %%%%%%%%%%% %%% %%%%% %%% %%%%% % % % % % %%%%% %%% %%% %%% % %%% % % %%% % % %%%%% % % % %%%%%
%   %     %     %   %   % % % %     % %     % %     %   %   %       %   % %     %         %   % %   %
% %%%%%%% % % %%%%% %%% % % % %%%%% % % %%%%% %%%%% %%% %%% % %%%%%%% %%% %%%%%%%%%%%%%%%%% %%% % % %
% %       % %   %     % % % %       % % %   % %   %     % % % %       % %     %       %     % %   % %
% % %%%%% %%%%% % %%%%% % % %%%%%%%%% %%% % % %%% %%%%%%% % %%% %%%%%%% %%%%% %%% %%% % %%%%% %%%%% %
% %     % %   %   %   %   %   %     % %   % %   %         %     %           %   % %   %           % %
% %%%%% %%% % %%%%% % %%% %%% % %%% % % %%% % % %%% %%% % %%%%%%% %%%%% % %%%%% % % %%%%%%%%%%% %%% %
%   %   %   %       %   %   %   % %   % %   % %   % %   %   % %       % % %     % % %         % %   %
%%% % %%% %%%%%%%%%%%%% %%% %%%%% %%%%% % %%%%%%% %%% %%%%% % % %%%%% % % % %%%%% % %%% %%%%% %%% % %
% % % %   %       %   %   % %       %   %       % %   %     % % %   % % % %   %   %   %   %       % %
% % % % %%% % %%% %%% %%% % %%%%% % % %%%%%%%%% % % %%% %%%%% % % % %%% % %%% % %%%%% %%% %%%%%%%%% %
%   % %   % %   %     % % %     % %   %       %   % %       %   % %     %   %   %   %   %   %       %
% %%% %%% % %%% %%%%% % % %%%%% % %%%%%%%%%%% %%%%% %%%%%%% %%%%% %%%%%%%%% %%%%% %%%%% %%% % %%%%%%%
% % %     %   %   % %   % %   %   %             %       % %       %     % % %     %   %   % %   %   %
% % %%%%%%%%% %%% % %%% % % % %%%%% % %%%%%%%%%%% %%%%% % %%%%%%%%% %%% % % % %%% % % %%% % %%% %%% %
% %         %   % %   % %   %       % %         % %     %     %   %   %   % %   %   %   %   % %     %
% %%%%%%%%% % %%% % % % %%%%% %%%%%%%%% %%%%%%% % % %%%%% %%% % % % % %%% % %%%%%%%%%%% %%%%% %%%%% %
%         %   %   % % %   % %   %       %   %   % % %     %   % %   %   % %     %     %     %   %   %
%%%%%%%%% %%%%% %%%%% %%% % %%% % %%%%%%% % % %%% % %%%%%%% %%% %%%%%%% %%%%%%% % %%% % %%% % %%% %%%
% %     %     % %     % % %   % % %       % %     % %     %     %     % %     %   % % %   % % %   % %
% % % % %%%%% % % %%% % % %%% % % %%%%%%%%% %%%%%%% % %%% %%% %%% % %%% % %%% %%%%% % %%% % % % %%% %
% % % % %     % %   %   % %   % %   %     %     %   % % %   %   % % %   % %     % %   %   % % %     %
% % % %%% %%%%% % % %%% % % %%% %%% % %%% %%% % % % % % %%% %%% % % % %%% % %%% % % %%% %%% % %%%%% %
%   % %   %     % % % % % % %   %   % %       % % % % %   % %     % %     % %     % % %   %   %     %
% %%% % %%% %%%%%%% % % % % % %%% %%% %%%%%%%%% % % % % %%% %%%%%%% %%%%%%% %%%%%%% % % % % %%% %%%%%
% % %   %   %       %   % % %   %   %     % %   % % % %   %     %         %     %   %   % % %   %   %
% % %%%%% %%% % %%%%% %%% % %%% %%% %%%%% % % %%% %%% %%% %%%%% %%%%%%%%%%%%% % % %%%%%%% % % %%% % %
% %   %     % %   %     %     %   %   %   %   % %   %     %   % %           % %   %       % % %   % %
% % % %%%%% %%% % %%%%% %%%%% %%% %%% % %%% %%% %%% %%%%% % % % % %%%%%%%%% % %%%%%%% %%%%% % % %%% %
%   %     %   % %     %     % % %   %   % % %     %       % % % %   %     % %   %     %     % %   % %
%%%%%%%%% %%% %%%%%%% %%%%% % % %%% %%%%% % %%% % %%%%%%%%% % % %%% % %%%%% %%% % % %%% %%%%% %%% % %
%     %   %   %       % %   % %   %       %     %   %       % %     % %   % %   % %   %   % %   % % %
% %%% % %%% %%% %%%%%%% % %%% % % %%% % %%%%%%%%%%% % %%%%% % %%%%%%% % % % % %%% %%% %%% % %%% % % %
% %   %   %   % %     %   %   % % %   % %     %     % %   % %           % % %   %   % %   % %   % % %
% % %%%%% %%% % % %%% % %%% %%% % % %%%%% % % % %%%%%%% % % %%%%%%%%%%%%% % %%% %%%%% % %%% % %%% % %
% %     %     % % %   % % % %   % % %   % % % % %       % % %     %     % %   %       % %   % %   % %
% %%% %%%%%%%%% % % %%% % % % %%%%% % % % % %%% % %%% %%% % % %%% % %%% % %%% %%%%%%%%% % % % %%% % %
% % %           % %   %   % % %   %   % % %   % %   % % % % % %     %   % %   %       % % % %   % % %
% % %%%%%%%%% %%%%%%% %%% % % % % %%%%% % %%% % %%%%% % % %%% %%%%%%% %%% % %%% %%% %%% % %%%%% % % %
% %         %     %   %   %   % % %   %     % % %     % %   %   %   % %   % %     % %     %   %   % %
% % %%%%% % %%%%% % %%% %%%%% % % % % %%% %%% % % %%%%% %%% %%% %%% % %%% % %%% % % % %%%%% % %%%%% %
% %     % % %   % % %   %   % % %   %   % %   % % %       %   %   % %   % %   % % % %   %   %     % %
% % %%%%% %%% % % % % %%%%% % % %%%%%%% %%% % % % % %%%%%%%%% %%% % %%% % %%% % % %%%%% % %%%%% % % %
% % %     %   % % % % %   % % % %         % % %   %         %     %   % %   % % %       %     % % % %
% % % % %%% %%% % % % % % % % % %%%%%%%%% % %%%%%%% %%%%% % %%%%%%% %%% % %%% % %%%%%%%%%%%%% % %%% %
% % % % %   % % % % %   % % % % %       % %     %   %   % %       %       %   %       %     % % %   %
% %%% %%% %%% % % % %%%%% % % % % %%%%% % % %%% % %%% % %%% % %%% % %%%%%%% %%%%%%%%% % %%% % % % %%%
%   %   % %     % %     % % % %   % %   % % % %   %   %   % %   % %     %   %       % % % %   %   % %
%%% %%% % % %%%%% % %%%%% % % %%%%% % %%% % % %%%%% %%%%% %%%%% %%%%%%% % % % %%%%% %%% % %%%%%%%%% %
%   %   % %       %         % %     % %   %   %     %   %     %         % % %     %   % %   %     % %
% %%% %%% % %%%%%%%%%%%%%%%%% % % %%% % %%%%%%% %%%%% % %%%%% %%%%%%%%%%% %%%%% %%%%% % % % % %%% % %
%     %   % %     %         %   % %   % %     % %     %     %     %     %   %   %     %   %   % % % %
%%%%% % %%%%% %%% % %%%%%%% %%%%% % %%% %%% % % % %%%%%%%%% %%%%% % %%% %%% % %%% %%%%%%%%%%%%% % % %
%   % % %       % %   %   %     % % %       %   % %     %   %   %   %   %   % %   %             %   %
% %%% % % %%%%% % %%% %%% % % %%% % %%%%%%%%%%%%% % %%% % %%%%% %%%%% %%% % % % %%% %%%%%%%%%%% %%% %
%     %   %   % %         % % %   % %   %   %     %   %   %     %         % % %     %         %     %
% %%%%%%%%% % %%%%%%%%%%%%% % % %%% % % % % % %%%%%%% %%%%% %%% % %%%%%%%%% % %%%%%%% %%%%% % %%%%%%%
% %       % %     %   %   % % %   %   % % %   %   %   %     % % % % %   %   %   %     %     %   %   %
% % %%% %%% %%%%% % % % % % %%%%% %%%%% % %%% % % % %%% %%% % % % % % % %%%%%%% % %%%%% %%%%%%% % % %
%   %   %   %   %   %   % %     % %   % %   % % % %   %   % %   %   % % %     % % %     %     %   % %
%%%%% %%% %%% % %%%%%%%%% %%%%% % % % % % % %%% % %%% %%%%% % %%% %%% % % % %%% %%% %%%%% %%%%%%%%% %
%       % %   %     %   %       % % % % % %   % %   %     % %   % %   %   %   %     %     %       % %
% %%%%%%% % %%%%%%% % % %%%%%%%%% %%% % % %%% % %%% %%%%% % %%%%% % %%%%%%%%% %%%%%%% %%% % %%%%% % %
%   %   % % %     %   %           %   % %   %   %   %   % % %     %     %     % %     % % %     %   %
% %%% % % % %%%%% %%%%%%%%%%%%%%%%% %%% %%%%%%%%% %%% %%% % % %%%%%%%%% % %%% % % %%% % % %%%%% %%%%%
% %   %   % %       %   %     %     %   %   %   %   %       %   %       %   %   % %   %   %     %   %
% % %%%%% % % %%%%% % % % % % % %%% % %%% % % % % % %%%%%%% %%% % %%%%%%%%% %%%%% % %%% %%% %%%%% % %
% %     % % %   %   % %   % % % %   % %   %   % % %       %   % % %       %     % % % % % % %     % %
% %%%%% % % %%% %%% %%% %%% % %%% %%% % %%%%%%% %%% %%%%% %%%%% % % %%%%% %%%%% % % % % % % % % %%%%%
%   %   % %   %   %   % %   %     %   % %     %   % %   % %     % % %   %     %   % %     % % %     %
% %%% %%% %%% %%% %%% %%% %%%%%%% % % % %%% % %%% % % %%% % %%%%% % % %%%%%%% %%%%% % %%%%% %%%%%%% %
% %   %     %     % %     % %     % % %     % %   % % %   %   % % % % %     %   %   % %     %     % %
% % %%% %%%%%%%%%%% %%%%%%% % %%%%% %%%%%%% %%% %%% % % %%%%% % % % % % %%% %%% % %%% % %%%%% %%% % %
% %   % %         %   %   % %   % % %   %   %   %   % %     %   %   % %   % %   %   % % %     % %   %
% %%% %%% % %%%%% % % % % % %%% % % % % % %%% %%%%% % %%%%% %%% %%%%% %%% % % %%%%% % % % % %%% %%% %
% % %   % %     %   % % %     %   %   %   % %     %       %     %       % % %   % % % % % %   %   % %
% % %%% % %%%%% %%%%% % % %%%%%%% %%%%%%%%% %%%%% %%%%% %%%%%%% % %%% % % % %%% % % % % % %%% % %%% %
% %   % % %   %     %   % %     %     %     %   %   %   %     % % % % % % %   % % % % % %   % % %   %
% % % % % %%% %%%%% %%%%%%% %%% %%%%% %%% % %%% %%% %%%%% %%% %%% % % %%% %%% % % % %%% %%%%% % % %%%
%   % %           %           %           %       %         %       %       %     %           %    .%
%%%%%%%%%%%%%%%%%%%%%%%%%%%%%%%%%%%%%%%%%%%%%%%%%%%%%%%%%%%%%%%%%%%%%%%%%%%%%%%%%%%%%%%%%%%%%%%%%%%%%
