%%%%%%%%%%%%%%%%%%%%%%%%%%%%%%%%%%%%%%%%%%%%%%%%%%%%%%%%%%%%%
%P  %       %         %     %   %         % %         %     %
%%% % %%%%% %%%%% %%% % %%% % % % % %%%%% % % %%%%%%% % % %%%
% % % %   % %     % % %   % % %   % %   %   % %       % %   %
% % % % %%% % %%%%% % %%% % %%%%% % % % %%%%% % %%%%%%% %%% %
%   % %   %   % %   % %   %     % %   % %     %       % % % %
% %%% %%% %%%%% % % % % %%%%%%% %%%%%%% % %%%%%%%%%%% % % % %
%   %   %     %   % % %     %       %   % %       %   %   % %
%%% %%% % % % %%%%% % %%%%% %%%%%%% % %%% %%%%% % % %%% %%% %
% % %   % % %   %   %     %   %   % %         % % %     %   %
% % % %%% % %%% % %%%%%%% %%% % % % %%%%%%%%% %%% %%%%%%% % %
%   % %   % %   %       %   % % % %   %   % %     %     % % %
% %%% % %%% %%% %%%%%%% %%% % % % %%% % % % %%%%% % %%% % % %
% %   %   %   %     %   % %   % %   %   % % %     %   % % % %
% % %%%%% %%% %%%%% % % % %%%%% %%%%%%%%% % % %%%%%%%%% % % %
%   %   %   %   %   % %   %           %   %   %     %   % % %
%%%%% % %%% %%% % %%% %%% %%% %%%%% % % %%% %%%%% % % %%% % %
%     %   % %   % %   % %   %   %   % % %   %     % %   % % %
% %%%%%%% %%% %%% % %%% %%% %%% % %%%%% % %%% %%%%% %%% % % %
%     % %     % %   % %   % %   %   %   %   % %   %     % % %
% %%% % %%%%%%% %%%%% % % % %%%%%%% % %%%%% % % %%% %%%%% % %
% %   %     %     %     % % %       % %   % % % %   %     % %
%%% %%%%% % % % %%% %%%%% % % %%%%% % % % % % % % %%% %%%%% %
%   %   % %   % %   %   %     %   % % % %   % %   %   %     %
% %%% % % %%%%% % %%% % %%%%% % % % % %%%%% % % %%% %%%%% %%%
%     % %   %   % %   %     % % % % %     %   % % %     % % %
% %%%%% %%% % %%% % %%%%%%% %%% % % %%%%% %%%%% % %%%%% % % %
%   % %   % %     %   %   %     % % % %   %     % %   % % % %
%%% % %%% % %%%%%%%%% % % %%%%%%% % % % %%% %%%%% % % % % % %
% %   % % %     %     % %   %   % %   %   %   %   % %   % % %
% %%% % % %%%%%%% %%%%% % %%% % % %%% %%% %%% % % % %%%%% % %
%   % % %       %   %   %     % %   %   %   % % % % % %   % %
%%% % % %%%%%%% %%% %%%%%%%%%%% %%% %%% %%% % % % % % % %%% %
%   %   %       %   %   %       %   % % %   %   % % %   %   %
% % % %%% %%%%% % %%% % % %%% %%% %%% % % %%%%%%% % %%% % % %
% % % %   %   % % %   % % %   %   %     % %       %   % % % %
% %%% % %%% % % % %%% % % %%%%% %%% %%%%% %%%%%%%%%%% % %%% %
% %   % %   % % %     %   %   %   % %   %         %   %     %
% % %%% % %%% % %%%%%%% %%% % %%% % % % %%%%%%%%% % %%%%%%% %
%   % % % %   % %     % %   %   % % % %   %       % %       %
% %%% % % % %%% % %%% % % %%%%% % % % %%%%% %%%%%%% %%% %%%%%
%     %   % %   % % %   %   %     %   %   % %         % %   %
%%%%% %%%%% %%%%% % %%%%%%% %%%%%%% %%% % % % %%%%%%% % % % %
%   %     % %   %     %   %     % % %   %   %       % % % % %
% % %%%%% % % % % %%%%% % % %%% % % % %%%%%%%%%%%%% % %%% % %
% % %     % % %   %     % %   % %   % %   %   %   % %     % %
% %%% %%%%% % %%%%% %%%%% %%% % %%% % % % % % % % %%%%% %%% %
%     %     %     % %   %   % %   % % % %   %   %     % %   %
% %%%%% %%%%%%%%% % % % %%% %%% % % % % %%%%%%%%%%%%% % % %%%
% %     %       % % % %   %   % % % % %   %           % %   %
% % %%%%% %%% %%% % % % %%%%% %%% % % % % %%%%%%%%% %%% %%% %
% %         % %   % % % %   %     % % % %         % %   %   %
% %%%%%%%%%%% % %%% % %%% % %%%%%%% % %%%%%%%%%%% % %%% % % %
%   %     %   % %   %     %       % %     %       %   % % % %
%%% %%% %%% %%% % %%%%%%% %%%%% %%% %%%%% % %%%%%%%%% % % % %
% %   %   %   % %   %   % %   %       %   % %       % % % % %
% %%% % % %%% % %%% % % %%% % % %%%%% % %%% % %%%%%%% %%% % %
%   % % %   % % % % % %     % % %   % %     % %   %   %   % %
% % % %%% % % % % % % %%%%%%% %%% % %%%%%%%%% % % % %%% %%% %
% %       % %     %         %     %             %       %  .%
%%%%%%%%%%%%%%%%%%%%%%%%%%%%%%%%%%%%%%%%%%%%%%%%%%%%%%%%%%%%%
