%%%%%%%%%%%%%%%%%%%%%%%%%%%%%%%%%%%%%%%%%%%%%%%%%%%%%%%%%%%%%%%%%%%%%%%%%%%%%%%%%
%P    %         %   %   %                   %       %     %             %       %
%%%%% % % %%%%% %%% % % % % %%%%%%%%% %%%%%%% % %%%%% %%% % % %%%%%%%%% %%%%%%% %
% %   % % %   %     % % % %         % %     % % %   %   % % %   %     %     %   %
% % %%%%% %%% % %%%%% % % %%%%%%%%% %%% %%% % % % % %%% % % %%% % %%%%%%%%% % % %
% % %   %   %   %     %   %         %   % %   % % %   % %     % % %           % %
% % % % %%% %%%%% %%%%%%%%% % %%%%%%% %%% %%%%% % % %%% %%%%%%% % % %%%%%%%%%%% %
% % % % %   %   %     %     % %     %     %   %   %     %   %   % %   %       % %
% % % % % %%% % %%%%% % %%%%% % %%% %%%%% % % %%%%%%%%%%%%% % %%% %%% % %%%%% % %
% %   % %     %     % % % %   %   %     % % %               % %       % %   % % %
% %%%%% % %%%%%%%%% % % % % %%%%% %%% %%% % %%%%%%%%% %%%%% % %%%%%%% % % %%% % %
% %   % % %         % % %       % % %     % %   %     %   % %   %   % % %   % % %
% % % % %%% %%%%%%%%% % %%%%% %%% % %%%%%%% % %%% %%% % % %%%%% % % %%% %%% % %%%
%   % %   % %         %   %   %   %       %   %   % % % %       % % %   %   %   %
%%%%% %%% % % %%%%%%%%%%% %%%%% %%% %%%%% %%%%% %%% % % %%%%%%%%% % % %%% % %%% %
%     %   % %   %   %     %   % %       % %     %   % %       %   % %   % %   % %
% %%% % %%% %%% %%% % %%%%% % % % %%%%% % % %%%%% % % %%%%%%% % %%% %%% % %%% % %
%   % % %     % %   %     % %   % %   % %   % %   % % %   %   %   %     %   % % %
% % %%% % %%% % % %%%%%%% % %%%%% %%% % %%%%% % %%% % %%% % % %%% %%%%%%% % % % %
% % %   % % % % %     %   % %         %     %     % % %   % % %   %   %   % % % %
% % % %%% % % % %%%%% % %%% % %%%%%%%%%%%%% %%%%% % % % %%% %%% %%% % %%%%% %%% %
% % %   %   %         %   % %   %         %   % % %   %   %   %     %     % %   %
%%% %%% %%%%%%%%%%%%%%% % % %%%%% %%%%%%% %%% % % %%%%%%% %%% %%%%% %%%%% % % % %
%     %               % %   %   % %   %   %   %   %     %   %       %   %   % % %
% %%%%%%%%%%%%%%%%%%% % %%%%% % % % %%% %%% %%% %%%%% % %%% %%%%%%%%% % %%%%% % %
% %       % %       % %       %   %     %     % %   % % %   %       % %   %   % %
% % % %%% % % % %%%%% %%%%%%%%%%%%% %%%%% %%% % % % % % % % % %%%%% % %%% % %%% %
%   %   %   % %     % % %         % %       % % % %   %   % % %   %   % % % %   %
% %%%%% %%%%% %%%%% % % % %%%%%%% % %%%%%%%%% % % %%%%%%%%%%% % % %%%%% % % %%% %
%   % %       % %   % %         %   %         %   %   %       % %       % %   % %
%%% % %%%%%%%%% % %%% %%%%%%%%% %%%%% % %%%%% %%%%% % % % %%%%% %%%%% %%% % % %%%
% % %   %       %   %     %         % % %   % %     %   % %   % %   % %   % %   %
% % % % % %%%%% %%% %%%%% % %%%%%%% % %%% % % % %%%%%%%%%%% % % % % % % %%%%% % %
% % % %   %   %   % %   % % %   %   %     % % %             % % % % % %     % % %
% % %%%%%%% % %%% % % % % %%% % % %%%%%%% % % %%%%%%%%%%%%% % % % % % %%%%% % % %
% %         %     % % %   %   % %   %   % % % %           % % %   % %   %   % % %
% %%%%%%%%%%%%%%% % % %%%%% %%% %%% % % %%% %%% %%%%%%%%% %%% %%%%%%% %%% %%%%% %
%     %         % %   %       % %     %   %   %     %   %   %   %   %   % %     %
%%% % %%% %%%%%%% %%%%%%%%% % % %%%%%%%%% % % %%%%% %%% %%% %%% % % %%% % %%% % %
%   %   % %     %   %     % % % %     %   % %     %   %   %     % %   % % %   % %
% %%%%% % % %%% %%% % %%% % % % % %%% % %%%%%%%%% %%% % % %%%%%%% %%% % % % %%% %
%   % % % %   %   %   % % % % %   %   % %   %     %   % % %     %   %   %   %   %
% % % % % %%% %%% %%%%% % % % %%%%% %%% % % % % %%% %%% %%% % % %%% %%% %%%%% %%%
% % %   % %   % %     %   % % %       %   % % % %   %       % %     %       % % %
%%% % %%% % %%% %%% %%% %%% % %%%%%%% %%%%% % %%% %%%%%%% %%% %%% %%%%%%%%% % % %
%   %   % % %     %     % % %     % % %   %   %   %     %   % %   %       % % % %
% %%%%% % % % % %%%%%%%%% % %%%%% % % % % %%%%% % % %%% %%% % % %%% %%%%% % % % %
%     %   % % %           % %     %     %       % %   % % % % % %   %     % % % %
% %%% %%%%% % %%%%%%% %%% % % %%%%% %%%%%%% %%%%% %%% % % % % %%% %%% %%%%% % % %
% % % %   % %   %     %   % %   % % %   %   %   %   % % % % %   % %   %     % % %
% % % % % % %%% % %%%%%%%%% %%% % % % % %%%%% % %%%%% % % % %%% % % %%% %%%%% % %
%   %   %   %   %           % % % % % %     % % %     % %   %   % %   %   %   % %
%%% %%%%%%%%%%%%%%%%% %%%%%%% % % % % %%%%% % % % %%%%% %%%%% %%% %%% %%% % %%% %
% % %       %       % %       % %   % %   %   %   % %   %   % %   % % %   %     %
% % %%%%% % % %%%%% % % % %%%%% %%%%% %%% %%%%%%%%% % %%% % % % %%% % %%%%%%%%% %
% %       % %   %   %   % %   %     %       %       %     % % %     %         % %
% %%%%%%%%% %%% % %%% %%%%% % %%%%% %%%%%%% % % %%%%%%%%%%% % %%%%% %%%%%%% %%% %
%     %   %     % % % %     %           %   % % %   %       %     % %       %   %
% %%%%% % %%%%%%% % % % %%%%%%%%%%%%% %%% %%% % % % % %%%%%%%%% % % % %%%%%%% %%%
%   %   %       % %   %       %   %   %   %   % % %   %   %     % % %         % %
% % % %%%%%%% %%% %%%%%%%%% % % % % %%% %%%%%%% % % %%% % % %%% %%% %%%%%%%%%%% %
% % % %   % %   %         % % % %   %   %       % % %   % % %   %   %           %
%%% % % % % %%% %%%%%%%%% % % %%%%%%% %%% %%%%% % %%% %%% % % %%% %%%%% %%%%%%% %
%   %   %     %   %     % % %             %     %     %   % %   %     %   %     %
% %%%%%%%%%%% % % %%% %%% % %%%%%%%%%%%%%%%%%%%%%%%%%%% %%% %%%%%%%%% %%%%% %%% %
%       %     % %     %   % %     %           %         %   %       % %     % % %
%%% %%%%% %%%%% %%%%%%% %%%%% %%% % %%%%%%%%% % %%%%%%%%% % % %%%%% % % %%%%% % %
%   %     %   %         %     % %   % %       % % %   %   % % % %   %   %   %   %
% %%% %%%%%%% %%%%%%%%%%% %%%%% %%%%% % %%%%%%% % % % % %%% % % % %%%%%%%%% % %%%
%   %     %       %       %   %     %   % %     %   % % %   %   %           % % %
% % %%%%% % %%%%% %%% %%%%% % % % %%% %%% % % %%% %%% % % %%%%% %%% % %%%%%%% % %
% %     %   %   %     %     % % %     %     %   %   % % %         % % %   %   % %
% %%%%% %%%%% %%%%%%%%% %%%%%%% %%%%%%% %%%%%%% %%% % % %%%%%%%%% % % % % % %%% %
%   % %     %         %     %   %   % % %     %   % % %   % %   % % % % %   %   %
%%% % %%% %%% %%% %%% % %%% % %%% % % % % %%%%%%% %%% %%% % % % %%% %%% %%%%%%% %
%   %   %     %   %   % % % %     % %     %   %   %     %   % %   % %   %     % %
% %%%%% %%%%%%% %%%%% % % % %%%%%%% %%% %%% % % %%% %%%%%%% % %%% % % %%% % % % %
%       %     %     % %   %       %   % %   %   %   %   %   % %     %   % % %   %
%%%%%%% % %%% %%%%% %%%%% % %%%%%%%%% %%% %%%%%%% % % % % %%% %%%%%%%%% %%% %%% %
%         %       %       %               %       %   %     %               %  .%
%%%%%%%%%%%%%%%%%%%%%%%%%%%%%%%%%%%%%%%%%%%%%%%%%%%%%%%%%%%%%%%%%%%%%%%%%%%%%%%%%
