%%%%%%%%%%%
%.       .%
%%%% %%%%%%
%P       .%
%%%%%%%%%%%
