%%%%%%%
%    P%
% %%% %
%  %  %
%%   %%
%  % .%
%%%%%%%
