%%%%%%%%%%%%%%%%%%%%%%%%%%%%%%%%%%%
%%%%         %%%%   %% %%%%%%%%% %%
%    %%%%%%%      % %%           %%
%%%%      %% %% % % %% %%%%%%%%%%%%
%    %%%% %% %%%% % %%            %
% %% %%   %% %%%% % %% %%%%% %%%% %
% %% %% %%%%           %%    % %% %
% %% %%   %% %%%%%%%%%%%% %% % %% %
%    %%%% %% %%           %% % %% %
% %%%%%   %% %% %%%%%%%%%%%% %    %
% %% %% %%%% %%        %%    %%%%%%
% %% %%      %% %%%%%% %% %%     %%
% %% %%%% %%%%% %P     %% %% %%  %%
% %% %%     %%% %%%%%% %% %%%%%%%%%
%            %%        %%         %
%%%%%% %%%%%%%%%%% %%%%%%%%%%%%%% %
%   %% %%   %%   % %              %
% % %% %%   %% % % % %% %%%%%%%%%%%
% % %% %%   %% % % % %% %        %%
%      %%%% %% %   % %% % %%%%%% %%
%% %%%%%%%% %% %%%%% %% %      % %%
%%          %%          %%%%%%%% %%
%%%%%%%%%%% %%%%%%%% %%%%%%%%%%% %%
%.                %%             %%
%%%%%%%%%%%%%%%%%%%%%%%%%%%%%%%%%%%
