%%%%%%%%%%%%%%%%%%%%%
%   %%%   %%        %
%% P   %%   %%      %
%  %%   %%   % %%   %
%     %    %        %
%%%%%%%%%%%%%%      %
% %%     . %%%%     %
% %  %%%%%%       % %
%           %  %%%  %
%%%%%%%%%%%%%%%%%%%%%	    