%%%%%%%
%   %P%
% %   %
% % %%%
%.%   %
%%%%%%%
