%%%%%%%%%%%%%%%
%P..........%.%
%%%%%%%%%%%.%.%
%.....%...%...%
%%%.%.%%%.%%%.%
%...%.......%.%
%.%%%%%%%%%.%.%
%.%.......%.%.%
%.%.%%%%%.%%%.%
%.......%.....%
%%%%%%%%%%%%%%%
