%%%%%%%%%%%%%%%%%%%%%%%%%%
% P  %    %%  %    %%    %
%%  %  %  %%%%  %%  %%   %
%   % %  %  %  %%    %%  %
%     %       %%%%%%    %%
%%%%%%%% %%%   %  %%%%%  %
%%%%%      %%%%   %%%.   %
% % %  %%%%   %%  %%%%%%%%
% %  %      %%%%     %  %%
%   % %%%%%    %%  %   %%%
%%%%%%%%%%%%%%%%%%%%%%%%%%