%%%%%%%%%%%%%%%%%%%%%%%%%%%%%%
%            %   %         %P%
% %%%%  %%%  %     % %%% % % %
%    %   % % %%%%% % % % %%% %
% % %%%% % %     % % %       %
% %%       %   % % % %%%%%%% %
% %% %%% %   %%% % % %     % %
% %% % %%%%%%% % % %    %  % %
% %%           % % %%%%%% %% %
% %%%%%%%%%%%% % %%%%   % %  %
%   %          %      %   %% %
% % % % %%%%%% % % % %%% %%%%%
% % % % %      % % % % %%%   %
% %   % % % %%%%     %     % %
% %% %% %%%   %%%%%%%%%%%%%% %
% %% %%   %%%   %          % %
% %%  %%%   %%  % % %%%% % % %
% %     %%%  %%%% %    % % % %
%         %%        %%   % % %
%%%%%%%%%%%%%%%%%%%%%%%%%%   %
%.                         % %
%%%%%%%%%%%%%%%%%%%%%%%%%%%%%%
