%%%%%%%%%%%%%%%%%%%%%%%%%%
%P                       %
% % %%%%%%%%%%%%%% % %%% %
% %        %     %     % %
% %%%%%%%%%% %%% %%% %%% %
% %%       % %     %   % %
% %% %%%%%%% % %%% %%% % %
%            % %%%     % %
%%%%%%%%%%%%%% %%% %%%%% %
%                       .%
%%%%%%%%%%%%%%%%%%%%%%%%%%
