%%%%%%%%%%%%%%%%%%%%%%%%%%%
%P  %   %     %     % %   %
%%% % % % %%% %%% % % % % %
% % % %   %     % % %   % %
% % % %%%%%%%%% % % %%%%% %
%   %         %   %   %   %
% %%% %%%%%%% %%%%%%% % % %
% %         % %     %   % %
% %%%%%%%%%%% % %%% %%%%% %
%             %   %      .%
%%%%%%%%%%%%%%%%%%%%%%%%%%%
