%%%%%%%%%%%%%%%%%%%%%
%P%   %           % %
% %%% % %%% %%%%% % %
%   % % % % %   %   %
%%% % % % % % % %%% %
% % %     % % %   % %
% % %%%%%%% % %%% % %
% %     %   % %   % %
% %%%%% % %%% % %%% %
%     % % % % %   % %
% %%% % % % % %%% % %
%   % % % % %   %   %
% % % % % % %%% %%%%%
% % % %   %   % %   %
% % %%%%%%% %%% % % %
% %   %     %   % % %
% %%% % %%% % %%%%% %
% % % % %   %     % %
% % % % % %%%%%%% % %
%   %   %          .%
%%%%%%%%%%%%%%%%%%%%%
