%%%%%%%%%%%%%%%%%%%%%%%%%%%%%%%%%%%%%%%%%%%%%%%%%%%%%%%%%%%%%
%P%                 %   %   %     %       %     % %       % %
% % %%%%%%%%%%% %%% % %%% % % %%% % %%%%% % % % % % % %%% % %
% %   %     %   %   %     %     % % %   %   % % %   % % %   %
% %%%%% %%% % %%% %%%%%%%%% %%%%% % % % %%%%% % % %%% % %%% %
% %     %   %   %         % %   % %   %     % % % %   %     %
% % %%%%%%% %%% %%%%%%%%% %%% % % %%%%%%%%% % % %%% % %%%%%%%
% %       % %   % %     %   % %   %       % % %     % %     %
% %%%%%%% % % %%% % % % %%% % %%%%% %%%%% % % %%%%%%% % %%% %
%   %     %   %     % % % % % %   % %   %   % %       % % % %
%%% % %%%%%%%%% %%%%% % % % % % % % %%% %%%%% % %%%%%%% % % %
% % %   %     % % %   %   % % % % % %       % % %     %   % %
% % %%% % %%% % % % %%% %%% % % % % % %%%%% % % % % %%%%% % %
% %     %   %     % %   %   %   %     %     % % % % %     % %
% %%%%%%%%% %%%%%%% %%%%% %%%%%%%%%%%%%%%%% % % % %%% %%%%% %
%   %       %       %     %     %     %   % % %   %   %     %
% %%% %%%%%%% %%%%% % %%%%% %%% % %%% % % % % %%%%% %%% %%%%%
%     %     % %     %   %     %   %     % % %       % %     %
% %%%%% % %%% % %%%%%%% %%% % %%%%%%%%%%% % %%%%%%%%% %%%%% %
% %     % %   %     % %   % %   %       % %   %           % %
% %%%%%%% % %%%%%%% % %%% % %%% % %%%%% % %%% % % %%%%%%%%% %
%         %       %     % %   %       % % %     % %       % %
%%%%%%%%% %%%%%%% % %%%%% %%% %%%%%%%%% % %%%%%%%%% %%%%% % %
%   %     %     % % %   % %     %       % %     %   %   %   %
% % % %%%%%%% % % %%% % % %%%%%%% %%%%%%% % %%% % %%% % %%% %
% % %   %     % % %   %   %       %   %   % % %   %   % %   %
% % %%% %%% % %%% % %%%%%%% %%%%%%% %%% %%% % %%%%% % %%% %%%
% %   %     % %   % %     %   % %     % %   %     % % %   % %
% %%%%%%%%%%% % % % % %%% %%% % % %%% % %%% %%% % % % % %%% %
%     %   %   % % % %   %     %   %   %   %   % %   %       %
% %%% % % % %%% % % % % %%%%%%% %%% % %%% % % %%%%%%%%%%%%%%%
% %   % %   %   % % % %   %   %   % % %   % %               %
% % %%% %%%%% %%% % % %%% % % %%% % %%% %%% %%%%%%%%% %%%%% %
% % %   %   %   % % %   % % %   % %   % % % %   %   %     % %
%%% % %%% %%%%% %%% %%%%% % %%% % %%% % % % % %%% % %%% %%% %
%   %   %     %   % %     % % %   %   % % % % %   %   % %   %
% %%%%% %%% % %%% % % %%%%% % %%%%% %%% % % % % %%%%% %%% % %
% %     %   % % %   %     %   %   %     %     % % %   %   % %
% % %%%%% %%% % %%%%%%%%% %%% %%% %%%%%%%%%%%%% % % %%% %%% %
% %   %   % % %           % %     %       %   % % %   %   % %
% %%% %%% % % % % %%%%%%%%% %%%%% % % %%% % % % % %%% %%% % %
%   %     % % % % %             % % % %     %   %   %   % % %
% % %%%%%%% % %%% % %%%%% %%%%% % %%% %%%%%%%%%%%%% %%% % %%%
% %     %   %   % %   % %   % % %   %     %           % %   %
%%% %%% % %%%%% % %%% % %%% % % %%% %%%%% % %%%%%%%%% % %%% %
%   %   %     % % %   % %   % % % %       %     %   % %     %
% %%% %%%%%%% % % % %%% % %%% % % %%%%%%%%% %%% % % % %%%%% %
% %         % %   % %   % %   %         %   % %   % %     % %
% %%%%%%%%% % %%%%% %%% % %%% %%% %%%%%%% %%% %%%%% %%%%% % %
% %     %   %   % %     %   %     %       % %     % %     % %
% % %%% % %%% % % %%%%% %%% %%%%%%% %%%%%%% % % % % %%%%% % %
%   %   %     %       % % %   %   %     %     % % %     % % %
%%%%% % %%%%%%%%%%%%%%% % %%% % % %%%%% %%%%%%% % %%%%% % % %
%     % %         %   % %   %   %   %   %       % %     % % %
% % %%%%% %%%%%%% % % % % % %%%%%%% % %%% %%%%%%%%% %%%%% % %
% % %   %   %     % %   % %       %   %     %     %   %   % %
% %%% % %%% % %%% % %%%%%%%%% %%% %%%%%%% % % %%% %%% % %%% %
%   % %   % % %   % %     %   % %   %   % %     %   % % %   %
% % % % %%% % %%%%% %%% % % %%% %%% % % %%%%%%%%%%% % %%% %%%
% %   %     %           %   %         %             %      .%
%%%%%%%%%%%%%%%%%%%%%%%%%%%%%%%%%%%%%%%%%%%%%%%%%%%%%%%%%%%%%
