%%%%%%%%%%%
%P%   %   %
% % % %%% %
% % %   % %
% % %%% % %
% % %   % %
% % % %%% %
% % %     %
% % %%%%% %
%   %    .%
%%%%%%%%%%%
