%%%%%%%%%%%%%%%%%%%%%%%%%%%%%%%%%%%%%%%%%
%P    %           %                 %   %
%%%%% %%%%%%%%% % % %%%%%%%%%%%%% % % % %
%   %         % % %     % %       %   % %
% % %%%%%%%%% % % %%%%% % % %%%%%%%%%%% %
% %     %   % % % %   %   %   %       % %
% %%%%% % % % % % % % %%% %%% % % %%% % %
%     %   %   % %   %     %   % %   % % %
%%%%% %%%%%%%%%%% %%%%%%% % %%% %%% %%% %
%     %         %   %   % % %     %     %
% % % %%% %%%%% % %%% % % % %%%%% %%%%%%%
% % % %   %     % %   % % %   % %   %   %
%%% % % %%% %%%%%%% %%% %%%%% % %%% % %%%
%   % % % %   %     % %   %   %     %   %
% % % % % %%% % %%%%% %%% % %%% %%%%% % %
% % %   %     % %     % %   %   %     % %
% % %%%%% %%%%% % % % % %%%%% %%% %%%%% %
% % % %   %     % % %   %     %   %     %
% % % % %%%%%%% % % %%%%% %%%%% %%% %%% %
% %   % %       % %     %     %   % %   %
% %%%%% %%% %%%%% %%%%% %%%%% %%% % % %%%
%     %     %       %   %     %   % %   %
%%%%% %%%%%%% %%%%%%% % % %%%%% %%% %%% %
%     %   %   %   %   % %       %   %   %
% %%%%% % % %%% % % %%%%%%%%% % % %%% %%%
%   %   % %   % % %   %     % % % %     %
% % % %%% %%% % %%%%% % % % % %%% %%%%%%%
% % %   %   %   %     % % % %   %       %
% % % %%%%% %%% % %%%%% % % %%% %%%%% % %
% %   %   % %   %       % %   %     % % %
% %%%%% % % % %%%%%%%%%%% %%%%%%%%% %%% %
% % %   % % % %         %         %   % %
% % % %%% % % % %%%%% %%%%%%% %%%%%%% % %
%   %   %   %   % %   %       %     % % %
%%% %%% %%% %%%%% % %%% %%%%%%% %%% % % %
%     % %   %       % % %     %   % % % %
% %%%%% %%%%% %%%%%%% % % %%% %%% % % % %
% %     %     %   %   % % %   %   % %   %
% % %%%%% %%%%% % %%% % % % %%% %%% %%% %
% %             %     %   %       %   %.%
%%%%%%%%%%%%%%%%%%%%%%%%%%%%%%%%%%%%%%%%%
