%%%%%%%%%%%%%%
% % % % % % %%
% % % % % % %%
% % % % % % %%
%           P%
% %%%%% %%%% %
% %%%        %
% %%% %%%%%%%%
%           .%
%%%%%%%%%%%%%%
