%%%%%%%%%%%%%%%%%%%%%%%%%%%%%%%%%%%%
%                                 P%
% %%%%%%%%%%%%%%%%%%%%%%%% % %%%%% %
% %% %% %               %% % %   % %
% %% %% %%%%%%% %%%%% %% % % % % % %
%    %%           %%% %% % % % % % %
%%%% %% %%%%%%%%%%%%% %% % %%% % % %
% %% %% %%            %%           %
% %%    %% %%%%%%%%%% %%%%% %%%%%%%%
% %% %%%%% %          %% %%       %%
%    %     % %%%%%%%% %% %%%%%%%% %%
%%%%%% %%%%%        %             %%
%      %%%%%%%%%%%% %%%%% %%%%%%%%%%
% %%%% %%%              %         %%
%   %%     %%% %%%%%%%%%%%%%%% %% %%
%%% %%%%%%   %                    %%
%.           %%%%%%%%%%%%%%%%%%%%%%%
%%%%%%%%%%%%%%%%%%%%%%%%%%%%%%%%%%%%
