%%%%%%%%%%%%%%%%%%%%
%...  ...  ..%.....%
% %%%%% %% %%%%% % %
%...   ...         %
%%%%%%%%.%%%%%%%%% %
%                  %
% %%%%% %%% %%%%%% %
%P         .     ..%
%%%%%%%%%%%%%%%%%%%%
